BABBBBBBBBABBBBBBBB
BABBBBAAABABABBBBAB
BAAAABABABABABAAAAB
BBBBAAABABABABBABAB
BAAAABABABAAAAAABAB
BAAAABABBBBBBBAABAB
BABBBBAAAAAAAAAABAB
BABAAAAABAABBBBBBAB
BABBBABABAABAAAAAAB
BABBAAABBBABABBBBBB
AABBBABBAAABABAAAAA
BABABABBAAABABABBBB
BABABBBBABAAAAAAAAB
BABAAAABABBBBBBBAAB
BABBAAABAAAAAAABAAB
BAAAAAABABBBBAABAAB
BBBABABBABAABABBAAB
BAAABAAAABAAAAAAABB
BABBBBBBBBABBBBBBBB 
