BABBBBABBBABBBABBBB
BABAABABAAAAAAAAAAB
BABABBABABABBBBBBAB
BABAAAABABAAAAAABAB
BABABAABAAABBBABBAB
BABBBBABABAAAAAABAB
BAAAAAAAABABBBBABAB
BABBBBABABAAAABABAB
BAAAAAABAAAABBBAAAB
BABBBBABABAABAAABAB
BAAAAAABBABABABBBAB
BAAAABAAAABABABAAAB
BBBBBBABAABABABBAAB
BAAAAAABAABABAABAAB
BABBBBABAABABBABAAB
BABAABABAABAAAAAAAB
BAAAAAABAABBBBABAAB
BABAABABAAAAAAABAAB
BABBBBABBBABBBABBBB