AAAAAAAAAAAAAAAAAAA
AAAAAAABBBBBBAAAAAA
AAAABBAAAAAAABBAAAA
AAABAAAAAAAAAAABAAA
AABAAAABAAAAAAAAABA
ABAAAABAABAAAAAABAA
ABAAAABAABAAAAABBBA
BAAAAAABBAAAAABBAAB
BAAAAAAAAAAAABABAAB
BAAAAAAAAAAAAABAABB
BAAAAAAAAAAAAAAABAA
ABAAAAAAAAAAAAAAABA
ABAAAAAAAAAAAAAAABA
AAAAAAAAAAAAAAAABAA
AABAAAAAAAAAAAABAAA
AAABAAAAAAAAAABAAAA
AAAABAAAAAAABBAAAAA
AAAAAABBBBABAAAAAAA
AAAAAAAAAAAAAAAAAAA