BBAABBBAAABBBAAAABB
ABABAAABABAAABAAABA
AAABABABABABABAAAAA
AAABAAABABAAABAAAAA
AAAABABBABBABAAAAAA
AAABAAAAAAAAAABAAAA
AABAABBAAAABBAABAAA
ABAABAABAABAABAABAA
ABAABAABAABAABAAABA
ABAAAABAAAABAAAAABA
ABAAAAAAAAAAAAAAABA
ABAAAAAABBAAAAAAABA
AABAAAABBBBBAAAABAA
AAABAAABAAAAAAABAAA
AAAABAAABABAABAAAAA
AAAAABBBBABBBBAAAAA
AAAAABAAAAAAAABAAAA
AABBBAAAAAAAAABBBAA
BBAABBBAAABBBAAAABB