BBABBBBABBBBBBBBBBB
AAAAAAAAAAAAAAAAAAA
BABBBBBBABBBBBBBBBB
BABAAAAAAAAAAAAAAAB
BBBABBBBBBBBBBBBABB
AAAABAAAAAAAAAABAAA
AABABABBBBBBBBABABA
AABABAAAAAAAABABABA
BABABABAAAAAABABABB
AABABABABBABABABABA
AABABABAAAABABABABA
AABAAABAAAABAAABABA
BBBABABBAABBABABABB
AABABAAAAAABABABABA
AABABBBBBBBABBABABA
AABAAAAAAAAAAAABABA
AABBBBBBBBBBBBBBABA
AAAAAAAAAAAAAAAAABA
BBABBBBABBBBBBBBBBB