BBBBBBBBBABBBBBBBBB
BABBBAAABABAAABAAAB
BAAABABABABAAABABAB
BABABABABABAAABAAAB
BABAAABAAABAAAAAAAB
BABBBBBBBABAAABABAB
BAAAAAAAAAAAAABABAB
BBABBBBAAAAAAABABAB
BAABAAAABABAAABBBAB
AAABAAAABBBAAABAAAA
BBBBABAAAAAAAABBBBB
BAAAABBBAAAAAAAAAAB
BAABBBAAABBAAAAAAAB
BAABAAAABBAAAAAAAAB
BAABAABBBAAABBBBBAB
BAABAAAAAAAABAAABAB
BAABAABBBBBAAABBBAB
BAAAAAAAAABABAAAAAB
BBBBBBBBBABBBBBBBBB