BBBBBBBABBBBABBABBB
ABAAABAABAAAAAAABAA
ABAABBAABAABBBBBBAA
ABAABAAAAAAAAAAAAAA
AAABBABBBAABABABBBA
ABABAABABAABABAAABA
ABABAABABAABABAAABA
ABABBBBABBABABBBABA
ABAAABAAAAABAAAAAAA
BBBAABBBBBABBBAABBB
ABAAAAAAAAAAAAAAAAA
ABABBBBBABBBBBAABAA
ABAAAAABAAAAABAABBA
ABABBBAAAAAAABAAABA
AAABAAABBBBBABAAABA
ABABBABBAAABABBBBBA
ABAAAAAAAAABAAAAAAA
ABAAAAAAAAABAAAAAAA
BBBBBBBABBBBABBABBB