BBBBBBBBBBBBBBBBBBB
BAAAAAAAAAAAAAAAABB
BABBBBBBAAAABAAAAAB
BABBBBBBAAAABAAAAAB
BABBBBBBAAAABBBBAAB
BABBBBBBAAAABAAAAAB
BABBBBBBAAAABAAAAAB
BABBBBBBBAAAAAAAAAB
BAAAAAAABABBBBAAAAB
BBBBBAAAAAAAABAAAAB
BAAAAABAAAAAABAAAAB
BAAAAABAAAABBBBBBAB
BAAAAABAAAABBBBBBAB
BAABBBBAAAABBBBBBAB
BAAAAABAAAABBBBBBAB
BAAAAABAAAABBBBBBAB
BAAAAABAAAABBBBBBAB
BBAAAAAAAAAAAAAAAAB								
BBBBBBBBBBBBBBBBBBB