AAAAAAAAAAAAAAAAAAA
AABBBAAAABBAAABBAAA
AAABAAAABAABABAABAA
AAABAAABAAAABAAAABA
AAABAAABAAAAAAAAABA
AAABAAAABAAAAAAABAA
AAABAAAAABAAAAABAAA
AABBBAAAAABAAABAAAA
AAAAAAAAAAABABAAAAA
AAABBBBAAAAAAAAAAAA
AABAAAABAAAAAAAAAAA
ABAAAAAAABAAAAABAAA
ABAAAAAAABAAAAABAAA
ABAAAAABBBBBABBBBBA
ABAAAAAAABAAAAABAAA
ABAAAAAAABAAAAABAAA
AABAAAABAAAAAAAAAAA
AAABBBBAAAAAAAAAAAA
AAAAAAAAAAAAAAAAAAA