BBBBBBBBBBBBBABBBBB
BAAAAAAAAAAAAAAAAAB
BAAAAABBBBBBAAAAAAB
BAABAAAAAAABBBBBAAB
BAABAAABBAAAAAABAAB
BAABABABBBBABABBAAB
BABBABBBAABABABAAAB
BAABAAAAAABABABBBBB
BABBBBBBBABABAAABAB
AAAAAAAAAABABAAAAAA
BBABBBABBAAABABBBBB
BAAABAABAABBBBBAAAB
BAAABABBABBAAABABAB
BABBBABAAABABABABAB
BABAAAAAAABABABABAB
BABABABABBBABAAABAB
BABBBABABAAABBBBBAB
BAAAAABAAABABAAAAAB
BBBBBBBBBBBBBABBBBB