BBBBBBBBBABBBBBBBBB
BAAAAAAABABAAAAAAAB
BABBBBBBBABBBBBBBAB
BABAAAAAAAAAAAAAAAB
BABAAABBBABBBBBAAAB
BABAABAAAAAAAAABAAB
BAAABAABBBABBBABAAB
BABBABBAAAAABBAABBB
AABBABABAAAAABAABBA
BAABABABABABBBABAAB
BAABAAAAAAAAAAABAAB
BABAABBBBABBBABABAB
BABAABBBBABBBBAABAB
BABABAAAAAAAABAABAB
BAAAABABBABBABAAAAB
BBBBAABABABABAABBBB
BAAAAAAAAAAAAAAAAAB
BAAAAAAABABAAAAAAAB
BBBBBBBBBABBBBBBBBB
