AAAABBBBABBBBAAAAAA
AAABAAABABAAABAAAAA
AAABAAAAAAAAABAAAAA
AAAAAAAAAAAAABAAAAA
AAAABAAAAAABAAAAAAA
ABBAABAAAABAAAABBBA
BAABAABAABAAAAAAAAB
BAAABAABAAAAABAAAAB
BBAAABABAAAABAAAABB
AAAAAAAAABAAAAAAAAA
BBAAABABAAAABAAAABB
BAAABAABAABAABAAAAB
BAABAABAAAABAABAAAB
ABAAABAAAAAABAABBBA
AAAABAAAAAAAABAAAAA
AAABAAAAAAAAAAAAAAA
AAABAAAAAAAAAABAAAA
AAAABAAABABAABAAAAA
AAAAABBBBABBBAAAAAA